NO ./assets/blue_wall.xpm
SO ./assets/green_wall.xpm
WE ./assets/purple_wall.xpm
EA ./assets/yellow_wall.xpm
F 33,40,47
C 2,10,18
1111
10E1
1111