1111111111111
10010000000C1
10PP011111111
1E00110000001
1111111111111
