1111101111111
1001C000000E1
1000011101111
1P00110000001
1111111111111
