1111111111111
100100000C0E1
1000011101111
1P00110000001
1111111111111
