1111111111111
100100000E1
1000011101111
1P0011000C001
1111111111111
