11111
10C11
1E001
1P001
11111
