11111111111111111111111111111111111111111111111111111111111111111111111111111111111111111111111111111111111111
100100000000000000000000000000000000000000000000000000000000000000000000000000000000000000000000000000000000C1
100100000000000000000000000000000000000000000000000000000000000000000000000000000000000000000000000000000000C1
100100000000000000000000000000000000000000000000000000000000000000000000000000000000000000000000000000000000C1
100100000000000000000000000000000000000000000000000000000000000000000000000000000000000000000000000000000000C1
100100000000000000000000000000000000000000000000000000000000000000000000000000000000000000000000000000000000C1
100100000000000000000000000000000000000000000000000000000000000000000000000000000000000000000000000000000000C1
100100000000000000000000000000000000000000000000000000000000000000000000000000000000000000000000000000000000C1
100100000000000000000000000000000000000000000000000000000000000000000000000000000000000000000000000000000000C1
100100000000000000000000000000000000000000000000000000000000000000000000000000000000000000000000000000000000C1
100100000000000000000000000000000000000000000000000000000000000000000000000000000000000000000000000000000000C1
100100000000000000000000000000000000000000000000000000000000000000000000000000000000000000000000000000000000C1
100100000000000000000000000000000000000000000000000000000000000000000000000000000000000000000000000000000000C1
100100000000000000000000000000000000000000000000000000000000000000000000000000000000000000000000000000000000C1
100100000000000000000000000000000000000000000000000000000000000000000000000000000000000000000000000000000000C1
100100000000000000000000000000000000000000000000000000000000000000000000000000000000000000000000000000000000C1
100100000000000000000000000000000000000000000000000000000000000000000000000000000000000000000000000000000000C1
100100000000000000000000000000000000000000000000000000000000000000000000000000000000000000000000000000000000C1
100100000000000000000000000000000000000000000000000000000000000000000000000000000000000000000000000000000000C1
100100000000000000000000000000000000000000000000000000000000000000000000000000000000000000000000000000000000C1
100100000000000000000000000000000000000000000000000000000000000000000000000000000000000000000000000000000000C1
100100000000000000000000000000000000000000000000000000000000000000000000000000000000000000000000000000000000C1
100100000000000000000000000000000000000000000000000000000000000000000000000000000000000000000000000000000000C1
100100000000000000000000000000000000000000000000000000000000000000000000000000000000000000000000000000000000C1
100100000000000000000000000000000000000000000000000000000000000000000000000000000000000000000000000000000000C1
10000111100111111111111111111111111111111111111111111111110000000000000000000000000000000000000000000000000001
1P0011E0000011110000000000000000001111111111111111111110000000000000000000000000000000000000000000000000000001
11111111111111111111111111111111111111111111111111111111111111111111111111111111111111111111111111111111111111
