11111111111111111111111111111111111111
10011111111111111111111111111111111101
10000001111111110111111111100000000001
10000001111111110111111111111100000001
100000000000000000000000000000000000E1
10011111111111111111111111111111111111
10000000000000000000000000000000000011
10000000000000000000000000000000000001
1000000000000000C000000000000000000001
10000000000000000000000000000000000001
10000000000000000000000000000000000001
10011111111110000000000000000000000001
1P011110000011111000000000000000000001
10011110000000001000000000000000000001
10011110000000001000000000000000000001
10011110000000001000000000000000000001
10011110000000001000000000000000000001
10011110000000001000000000000000000001
10011110000000001110000000000000000001
10011110000000001000000000000000000001
10011110000000001000000000000000000001
11111111111111111111111111111111111111
